# ACUSTOM set aliases
alias gs='git status '
alias ga='git add '
alias gb='git branch '
alias gbd='git branch -d'
alias gbD='git branch -D'
alias gc='git commit'
alias gd='git diff'
alias go='git checkout '
alias gob='git checkout -b '
alias gf='git fetch '
alias gr='git rebase '
alias grm='git rebase origin/master'
alias grd='git rebase origin/develop'
alias grc='git rebase —-continue'
alias gra='git rebase —-abort'
alias god='git checkout develop'
alias gom='git checkout master'
alias pull='git pull'
alias gsa='git stash apply'
alias gsl='git stash list'
alias gsd='git stash drop'
alias gss='git stash save'
alias log='git log --decorate --pretty=oneline --abbrev-commit --graph --all'
alias greset='git checkout -- .;git clean -f -d'
alias openb='open -e ~/.bash_profile'
alias sq='git rebase -i'
alias amend='git commit --amend -m '
alias gp='git push'
alias gps='git push --set-upstream origin'
alias allpid='ps -ax'
alias pid='ps -ax | grep' 
alias md='mkdir' 
alias show='defaults write com.apple.finder AppleShowAllFiles YES;killall Finder'
alias hide='defaults write com.apple.finder AppleShowAllFiles NO;killall Finder'
alias record='xcrun simctl io booted recordVideo '